----ALPH
--EPSILA
-DA---O-
-BOME-N-
TM-AGP--
EA--IS-D
EL-IHC-E
B-----ATL
