----ALPH
--EPSILA
-DA---O-
ABOME-N-
TM-AGP--
EA--IS-D
BL-IHC-E
-----ATL
