----ALPH
--EPSILA
-DA---O-
ABDEL-N-
GM-ATP--
EA--IS--
ML-IHC-B
O----ATE
