ADUMREB--
-REHPIC--
--INYOV--
--CDO----
S-HODTIYE
E--FALTXN
T----YEOI
I-----PRG
-------AM
