RAES----
CBAKIRUN
HEIRYBA-
--NARGL-
--TM-A--
--H-ANT-
K--COUN-
NIGHTS--
